mention - упомянуть
suite - люкс 
overboad - за бортом 
initially - изначально 
purchase -  покупка
condition -  состояние 
net worth -  собственный капитал 
hurry up- торопиться
addicts - наркоманы 
proud - гордый 
forbid- запрещать
drug - лекарство, наркотик
issue - проблема глагол - выдавать
trust - доверять 
instead - вместо 
inconvenience - неудобство 
might - мощь, сила
service - обслуживать 
decision - решение (дэсижн)
involved - вовлеченный 
mysterious - таинственный, загадочный
nonsense - бред
such - такой
perfeclty normal- совершенно нормальный 
drills - сверла, ед.число - сверло или дрели
beefy -  мясистый, упитанный, массивный
hardly - едва, hardly any neck - почти нет шеи 
although - несмотря на то что, хотя(олзоу) 
mustache - усы (мэсташ)
thin - худой. Когда говорят о телосложении человека 
twice - наречие. дважды, вдвое
which came in very useful - который пришелся очень кстати 
craning - вытягивание 
fences - заборы 
garden - сад 
sorcerer -  колдун, чародей, маг, волшебник 
spying- шпионство
finer boy - лучший мальчик
amount of neck - объем шеи 
anywhere - в  люом месте 
fear - страх, боязнь
discover -  обнаружить, открывать 
greatest -   величайший 
bear - глагол - вынести
found out - выяснил(о чем-то, ком-то), find out - выяснить
several - наречие - несколько 
pretend- притворяться 
good-for-nothing - ни на что не годный
as - как, насколько. союз - в то время как
shudder -  содрогаться, вздрагивать ( от чего-то) 
arrive - приехать, приезжать 
mixing - смешивание 
keep away -  держаться подальше 
like that -  таким образом, in situation like that - в такой ситуации
hop -  прыгать
to boil -  кипятить, варить
pick on somebody -  задираться, приставать на кого-нибудь 
silence - тишина, молчание 
toodles - форма прощания"пока"
deliberately - специально, умышленно
disobey - не слушаться, не подчиняться
i have got to -  я должен
flex - гл. сгибать. сущ. flex wall - гибкая стена 
right off -  сразу, немедленно
entryway -  прихожая
closet-  шкаф
act - действовать 
crave - жаждать (чего-то). to crave after admiration — жаждать восхищения 
desire - желание. I had a burning desire to win - У меня было горячее желание победить 
abuse -  злоупотреблять, издеваться, оскорблять 
at will -  наречие -  по желанию. He abused them at will
victim -  жертва 
mastermind - управлять, руководить  
scar -  шрам 
hidden -  скрытый 
obsession - одержимость 
royal -  королевский
denie -  отрицать 
jail -  тюрьма, тюремное заключение 
enough - наречие - достаточно - (энаф) 
gain-  рост
dull -  вялый, скучный(дал)
suggest - предлагать (сжэст) 
tie - галстук
pick out -  выбирать 
gossip - сплетничать(госэп) 
hum - напевать с закрытым ртом, гудеть (хам) 
happily - наречие - счастливо, радостно(хапэли) 
wrestle - бороться (рэсэл) 
screaming - кричащий 
none - никто
notice - обращать внимания(ноутэс)
tawny - рыжевато-коричневый(тоунэй)
owl - сова (аол)
flutter - порхать(флэттэ)
past - предлог -  мимо, за
briefcase - портфель (бриифкэйс) 
peck - чмокнуть (пээк)
cheek -  щека(чиик) 
miss - промахиваться 
tantrum - истерика (тантрум)
throw -  бросать(фроy)
cereal - хлопья(сирэел) 
chortle - хихикать(чоутэл)
pick up - поднять
tyke - шалун (тайк) 
expose - разоблачать 
sinister - зловещий 
purpose - цель (пээпэс) 
truly - наречие - действительно, поистине(т!рли)  
laid - проложенный(лэйд) 
peculiar - особенный(пэкилиэ)
for a second - на секунду
realize -  понимать (риелайз)
jerk - дергать (жэак)  
tabby - полосатый(т!абей)
in sight - наречие - в поле зрения (ин--сайт) 
thinking of - думать о 
blink - моргать (блинк)
stare - пристально смотреть (стээ)
shake - встряхивать
he thought - он думал (хи т!оот)
edje - край (эж)
else - местоимение - другой 
drive out - вытеснять
traffic jam - дорожная пробка
cloak - плащ, мантия(кл(о)к) 
the getups - наряды
suppose - предполагать (с--п(о)з) 
drum - барабанить, стучать пальцами 
steer - управлять (стээ)
fell - упал (фэл)
huddle - толпа( хад!л)
weirdos - чудаки(виэд(о)з)
close by - рядом
except - предлог - кроме
imagne - представлять "что-то в воображении,голове" (имэжн) 
resolution - разрешение(рэзелэшн) 
reject - отклонять(рэжэкт)
seek - стремиться(сиик)
exist - существует(экзист)
anxiety - беспокойство, тревога(э(н)заэтэй) 
match - соответствовать (маэч) 
concern- заботиться(кнсэр!н) 
former - прилагательный - бывший 
comply - исполнять (кмплай)
subpoena - повестка в суд (сыпиина) 
order- предписывать 
classified - секретный (кл!асифайд) 
record - запись 
turn over - передавать
court - суд (кот!)
familiar - привычный, знакомый (фэмилия)
source - источник 
matter- вопрос(ма&т!a&)
contempt - неуважение (кнтэмп!т!)
raw - необработанный
rob - грабить
shame - стыд, позор глагол - пристыдить(шэйм)
hill - гора, возвышенность (хиэл)
dry - сухой, засушливый (д!рай)
foreigner - иностранец(фор!эне)
carry on - продолжать
staff - персонал, сотрудники (стаф)
confused - смущенный (конфьюзд)
allright - ок, ладно, хорошо.
pretty much - довольно много (пури мач)
storage - место хранения 